NO ./textures/bluestone.xpm
SO      ./textures/greystone.xpm
EA ./textures/wall.xpm
WE ./textures/redbrick.xpm

F 50,100,0
C 50,30,0

        1111111111111111111111111
        1000000000110000000000001
        1011000001110000010000001
        1001000000000000101000001
1111111110110000011100000100000N1
100000000011000001110111111111111
1000000000110000000000001
1000000000110000000000001
1000000000110000000000001
1000000000110000000000001
1000000000110000000000001
1000000000110000000000001
1000000000110000000000001
1000000000110000000000001
1000000000110000000000001
1000000000110000000000001
1000000000110000000000001
1000000000110000000000001
1000000000110000000000001
1000000000110000000000001
1000000000110000000000001
1000000000110000000000001
1000000000110000000000001
1000000000110000000000001
1000000000110000000000001
1000000000110000000000001
1000000000110000000000001
1000000000110000000000001
1000000000110000000000001
1000000000110000000000001
1000000000110000000000001
1000000000110000000000001
1000000000110000000000001
1000000000110000000000001
1000000000110000000000001
1000000000110000000000001
1000000000110000000000001
1000000000110000000000001
1000000000110000000000001
1000000000110000000000001
1000000000110000000000001
1000000000110000000000001
1000000000110000000000001
1000000000110000000000001
1000000000110000000000001
1000000000110000000000001
1000000000110000000000001
1000000000110000000000001
1000000000110000000000001
1000000000110000000000001
1000000000110000000000001
1000000000110000000000001
1000000000110000000000001
1000000000110000000000001
1000000000110000000000001
1000000000110000000000001
1000000000110000000000001
1000000000110000000000001
1000000000110000000000001
1000000000110000000000001
1000000000110000000000001
1000000000110000000000001
1000000000110000000000001
1000000000110000000000001
1000000000110000000000001
1000000000110000000000001
1000000000110000000000001
1000000000110000000000001
1000000000110000000000001
1000000000110000000000001
1000000000110000000000001
1000000000110000000000001
1000000000110000000000001
1000000000110000000000001
1000000000110000000000001
1000000000110000000000001
1000000000110000000000001
1000000000110000000000001
1000000000110000000000001
1000000000110000000000001
1000000000110000000000001
1000000000110000000000001
1000000000110000000000001
1000000000110000000000001
1000000000110000000000001
1000000000110000000000001
1000000000110000000000001
1000000000110000000000001
1000000000110000000000001
1000000000110000000000001
1000000000110000000000001
1000000000110000000000001
1000000000110000000000001
1000000000110000000000001
1000000000110000000000001
1000000000110000000000001
1000000000110000000000001
1000000000110000000000001
1000000000110000000000001
1000000000110000000000001
1000000000110000000000001
1000000000110000000000001
1000000000110000000000001
1000000000110000000000001
1000000000110000000000001
1000000000110000000000001
1000000000110000000000001
1000000000110000000000001
1000000000110000000000001
1000000000110000000000001
1000000000110000000000001
11110111111111011101010010001
11000000110101011100000010001
10000000000000001100000010001
10000000000000001101010010001
110000011101010111110111100111
11110111 1110101 101111010001
11111111 1111111 111111111111





